NO ./texture/blue_tile.xpm
SO ./texture/red_white.xpm
WE ./texture/SnowbrickL.xpm
EA ./texture/Stone1L.xpm

F 220,100,0
C 144,215,236

1111111111
1S00110001
1000000001
1000110001
1111111111